###########
#        O#
#    P  ###
#         #
######    #
#         #
#      X  #
#         #
###########